########################################
#......................................#
#......................................#
#......................................#
#......................................#
#.........##...........................#
#.......#...#..........................#
#...........#..........................#
#...........#..........................#
#..........#...........................#
#........#####.........................#
#......................................#
#......................................#
#......................................#
#......................................#
#......................................#
#......................................#
#......................................#
#......................................#
#......................................#
#......................................#
#......................................#
#......................................#
#......#...............................#
#......#....###################........#
#......#....#.................#........#
#......#....#.................#........#
#......#....#.........###.....#........#
#......#....#...........#.....#........#
#......#....#...........#.....#........#
#......#....#############.....#........#
#......#......................#........#
#......#......................#........#
#......########################........#
#......................................#
#......................................#
#......................................#
#......................................#
#......................................#
########################################