#######################################
#.....................................#
#.....................................#
#.....................................#
#.....................................#
#.....................................#
#...........#########....#..#######...#
#...........#............#.....#......#
#...........#............#.....#......#
#...........#............#.....#......#
#...........########.....#.....#......#
#...........#............#.....#......#
#...........#............#.....#......#
#...........#............#.....#......#
#.....................................#
#.....................................#
#.....................................#
#.....................................#
#.....................................#
#.....................................#
#.....................................#
#.....................................#
#.....................................#
#.....................................#
#.....................................#
#.....................................#
#.....................................#
#.....................................#
#.....................................#
#.....................................#
#.....................................#
#.....................................#
#.....................................#
#.....................................#
#.....................................#
#.....................................#
#.....................................#
#.....................................#
#.....................................#
#######################################