#######################################
#.....................................#
#.....................................#
#.....................................#
#.....................................#
#.........##..........................#
#.......#...#.........................#
#...........#.........................#
#...........#.........................#
#..........#..........................#
#........#####........................#
#.....................................#
#.....................................#
#.....................................#
#.....................................#
#.....................................#
#.....................................#
#.....................................#
#.....................................#
#.....................................#
#.....................................#
#.....................................#
#.....................................#
#......#..............................#
#......#....###################.......#
#......#....#.................#.......#
#......#....#.................#.......#
#......#....#.........###.....#.......#
#......#....#...........#.....#.......#
#......#....#...........#.....#.......#
#......#....#############.....#.......#
#......#......................#.......#
#......#......................#.......#
#......########################.......#
#.....................................#
#.....................................#
#.....................................#
#.....................................#
#.....................................#
#######################################